ジニデウチガロドヂオズャ
そのていどかれっとうしゅ
ビニイバギオヨドデミヨゾンタユ
ほのおはこうやってもやすんだよ
ジニモゾメバワロラニイオボドガドニウゲヌエ、ガエズデミラオ
そのむすめはわれらのおうふっかつのいけにえ、かえしてもらう
あ → ア
い → ウ
う → オ
え → エ
お → イ
か → ガ
き → グ
く → ゴ
け → ゲ
こ → ギ
さ → ザ
し → ズ
す → ゾ
せ → ゼ
そ → ジ
た → ダ
ち → ヅ
つ → ド
て → デ
と → ヂ
な → ナ
に → ヌ
ぬ → ノ
ね → ネ
の → ニ
は → バ
ひ → ブ
ふ → ボ
へ → ベ
ほ → ビ
ま → マ
み → ム
む → モ
め → メ
も → ミ
や → ヨ
ゆ → ヤ
よ → ユ
ら → ラ
り → ル
る → ロ
れ → レ
ろ → リ
わ → ワ
ゐ → ヰ
ゑ → ヱ
を → ヲ
ん → ン
